.                            .
.                            .
.                            .
.                            .
.                 ...        .
.                ....   )    .
.      P         ....        .
.              ......   ......
.              ......   ......
.              ......        .
.           .........        .
.         ........           .
.       ..........           .
.       ......               .
.                    ....    .
.                ........    .
.      9     ..........      .
....................         .
....................         .
....................  ........