..........................   ..........................
..........................   ..........................
..........................   ..........................
..........................   ..........................
..........................   ..........................
........................       ........................
.....................             .....................
...................                 ...................
...................                 ...................
...................                 ...................
...................                 ...................
...................                 ...................
...................                 ...................
...................        P    $   ...................
.......................................................