....................  ........
.    .                       .
.    .                       .
.   (.                       .
.)   .                       .
.    .      ---      P       .
.    .            .......    .
.    .   ---      .......    .
.    .            .......    .
.    .---         .......    .
.                 .......    .
.                            .
.                         ---.
.               ..      >    .
.             ....     ---   .
.          .......   <       .
.          .......-----      .
.                            .
.            9               .
......  ......................